TTTTTTTTTTTTTTTT
0H00000000000000
0000000000000000
00S00H0000000000
0000000000000000
000000S000000000
0h00000000000000
0000000000000000
0000000000000000
00S0000000000000
0000000000000000
tttttttttttttttt
