00000000000000000000000000000000000000000000000000
0000000000000000000000000000000000BBBBBBB000000000
0000000000000000000000000000000000BBBBBB0000000000
000000000000000000000000000000000BBBBBBBB000000000
000000000000000000BBBBB0000000000BBBB0000B00000000
000000000000000000BBBBBB000000000BBBB0000B00000000
0000000000000000B00000BBB00000000BBBB00000B0000000
000000000000000000C000BBB00000000BBBBBBB0000000000
00000000000B0000C00000CBB000000000000BBBB000000000
00000000000B00000000000000000000000000BB0000000000
0000000000000000000bbbbbbb00000wwwwwwwBB0000000000
00000000000000000bbbbbbbbbbbbbbbbbb0BBB00000000000
00000000000000000000000000000000000BBBB00000000000
00000000000000000000000000000000000BBBB00000000000
000000000000000000000000000000000000BBB00000000000
00000000000000BBBBBBBBBBBBBB00000000000BBB00000000
00000000000000000000000000000000000BBBB00000000000
000000000000000000000000000000000000BBB00000000000
000000000000000wwwwwwww000000000000000000000000000
000000000000000000wwww0000000000000000000000000000
0000000000000000000000B000000000000000000000000000
00000000000000000000BBB000000000000000000000000000
00000000000000000000BBB000000000000000000000000000
0000000000000000000BBBB000000000000000000000000000
0000000000000000000BBBB000000000000000000000000000
000000000000000000000BB000000000000000000000000000
00000000000000000000000BBB000000000000000000000000
00000000000000000000000BBBB00000000000000000000000
00000000000000000000000BBBB00000000000000000000000
00000000000000000000000BBBB00000000000000000000000
000000000000000000000000BBB00000000000000000000000
000000000000000000000000BBB00000000000000000000000
000000000000000000000000BBBB0000000000000000000000
000000000000000000000000BBB00000000000000000000000
00000000000000000000000000000000000000000000000000
00000000000000000000000000000000000000000000000000
00w00000000000000000000000000000000000000000000000
00000000000000000000000000000000000000000000000000
00000000000000000000000000000000000000000000000000
000000000w0000000000000000000000000000000000000000
00000000000000000000000000000000000000000000000000
00000000000000000000000000000000000000000000000000
000000000w0000000000000000000000000000000000000000
00000000000000000000000000000000000000000000000000
00000000000000000000000000000000000000000000000000
00000000000000000000000000000000000000000000000000
00000000000000000000000000000000000000000000000000
00000000w00000000000000000000000000000000000000000
00000000w00000000000000000000000000000000000000000
000000w0000000000000000000000000000000000000000000


