00000000000000000000000000000000000000000000000000
00000000000000000000000000000000000000000000000000
00000000000000000000000000000000000000000000000000
00000000000000000000000000000000000000000000000000
00000000000000000000000000000000000000000000000000
00000000000000000000000000000000000000000000000000
00000000000000000000000000000000000000000000000000
00000000000000000000000000000000000000000000000000
0000000BBBBB0000BBBBBBBBBBBBB00000b00b000000000000
0000000B00000000000000000000B00000B0VB000B00000000
0000000B00000000000000000000B00000B00B000B00000000
0000000BBBBB0000BBBBBBBBB00UB00000BBBB000000000000
000000000000000000000000BBBBB00000BBBB000000000000
000000bbbbBB0000000000000000000000000B000000000000
000000000000000M000000000000000000000000d000000000
0000000000BBbbbbbb0bbbbbbb00000wwwwwwwBB0000000000
00000000000T00000bbbbbbbbbbbbbbbbbb0BBB00000000000
00000000000000000000000000000000000BBBB00000000000
00000000000000000000000000000000000BBBB00000000000
00000000000000000Y000000000000000000BBB00000000000
00000000000000BBBBBBBBBBBBBB00000000000BBB00000000
00000000000000000000000000000000000BBBB00000000000
0000000000000wwwww00000000000000000SBBB00000000000
00000000000000Nwwwwwwww000000000000000000000000000
000000000000000000wwww0000000000000000000000000000
0000000000000000000000B000000000000000000000000000
00000000000000000000BBB000000000000000000000000000
00000000000000000000BBB000000000000000000000000000
0000000000000000000BBBB000000000000000000000000000
0000000000000000000BBBB000000000000000000000000000
000000000000000000000BB000000000000000000000000000
00000000000000000000000BBB000000000000000000000000
00000000000000000000000BBBB00000000000000000000000
00000000000000000000000BBBB00000000000000000000000
00000000000000000000000BBBB00000000000000000000000
000000000000000000000000BBB00000000000000000000000
000000000000000000000000BBB00000000000000000000000
000000000000000000000000BBBB0000000000000000000000
000000000000000000000000BBB00000000000000000000000
00000000000000000000000000000000000000000000000000
00000000000000000000000000000000000000000000000000
00w00000000000000000000000000000000000000000000000
00000000000000000000000000000000000000000000000000
00000000000000000000000000000000000000000000000000
000000000w0000000000000000000000000000000000000000
00000000000000000000000000000000000000000000000000
00000000000000000000000000000000000000000000000000
00000000000000000000000000000000000000000000000000
00000000000000000000000000000000000000000000000000
00000000000000000000000000000000000000000000000000




