00000000000000000000000000000000000000000000000000
0000000000000000000000000000000000BBBBBBB000000000
0000000000000000000000000000000000BBBBBB0000000000
000000000000000000000000000000000BBBBBBBB000000000
000000000000000000BBBBB0000000000BBBB0000B00000000
000000000000000000BBBBBB000000000BBBB0000B00000000
0000000000000000B00000BBBS0000000BBBB00000B0000000
0000000000000000000U00BBB00000000BBBBBBB0000000000
00000000000B0000M00000NBB000000000000BBBB000000000
00000000000B000000000000000000000000V0BB0000000000
00000000000T0000000bbbbbbb00000wwwwwwwBB0000000000
00000000000000000bbbbbbbbbbbbbbbbbb0BBB00000000000
000000000000000000R0000000000000000BBBB00000000000
00000000000000P0000000W000000X00000BBBB00000000000
00000000000000000Y0000000000Z0000000BBB00000000000
00000000000000BBBBBBBBBBBBBB00000000000BBB00000000
00000000000000000000000000000000000BBBB00000000000
0000000000000000000000000Q0000000000BBB00000000000
000000000000000wwwwwwww000000000000000000000000000
000000000000000000wwww0000000000000000000000000000
0000000000000000000000B000000000000000000000000000
00000000000000000000BBB000000000000000000000000000
00000000000000000000BBB000000000000000000000000000
0000000000000000000BBBB000000000000000000000000000
0000000000000000000BBBB000000000000000000000000000
000000000000000000000BB000000000000000000000000000
00000000000000000000000BBB000000000000000000000000
00000000000000000000000BBBB00000000000000000000000
00000000000000000000000BBBB00000000000000000000000
00000000000000000000000BBBB00000000000000000000000
000000000000000000000000BBB00000000000000000000000
000000000000000000000000BBB00000000000000000000000
000000000000000000000000BBBB0000000000000000000000
000000000000000000000000BBB00000000000000000000000
00000000000000000000000000000000000000000000000000
00000000000000000000000000000000000000000000000000
00w00000000000000000000000000000000000000000000000
00000000000000000000000000000000000000000000000000
00000000000000000000000000000000000000000000000000
000000000w0000000000000000000000000000000000000000
00000000000000000000000000000000000000000000000000
00000000000000000000000000000000000000000000000000
000000000w0000000000000000000000000000000000000000
00000000000000000000000000000000000000000000000000
00000000000000000000000000000000000000000000000000
00000000000000000000000000000000000000000000000000
00000000000000000000000000000000000000000000000000
00000000w00000000000000000000000000000000000000000
00000000w00000000000000000000000000000000000000000
000000w0000000000000000000000000000000000000000000


